....................
....................
....................
....................
......######........
......#.............
......######........
...........#........
...........#........
....................
......#.............
......#.............
......#.............
......#.............
......#######.......