....................
....................
....................
..#########.........
..#.................
..#.................
..#.................
..#.................
..#.................
..#.................
..#.................
..#########.........
....................
....................
....................